.##.............
.......##.......
................
...#......###...
...#............
...#............
................
.......###......
......##........
................
................
................