................
................
..........##....
....##....##....
................
................
................
................
.......#####....
.....###...#....
................
................