................
................
................
......######....
......######....
...........#....
......#.##.#....
........##......
................
........##......
........##......
........##......