................
................
.....#######....
................
...........#....
.....#####.#....
...........#....
......######....
................
................
................
................