................
................
................
...##########...
................
................
..############..
................
................
................
................
................