................
...#............
...#............
...##........##.
.............#..
......#.........
......##........
...#............
...#............
..#......###....
................
................