................
.............#..
.............#..
.....##......#..
.............#..
................
........#.......
.#....###.......
.#......#.......
.##........#....
................
................