................
.........##.....
.........##.....
...##....##.....
....#....##..##.
....#.........#.
....#.........#.
...##..##.....#.
.......#......#.
.......#........
.......#........
................