................
................
................
................
....##..........
....#....#..#...
....#....######.
....##........#.
....#...........
....#...........
....##..........
................