................
................
................
.........#......
....###..####...
....#.......#...
....#...........
....#...........
....##..........
.........###....
................
................