.##.............
.##...###...###.
.#.....#.....#..
.#.....#.....#..
.##...###...###.
................
.#.....#.....#..
.##...###...###.
................
.#.....#.....#..
.##...###...###.
......###.......