................
................
................
......##........
......##........
...#............
...#.......#....
...#.......#....
..........##....
................
................
................