................
................
................
................
....#####....##.
........#.....#.
..............#.
..............#.
.#............#.
.##.............
..##............
................