................
................
................
...#.......###..
...##........##.
................
................
........#.......
........#.......
......##........
................
................