................
..####..........
..#..#..........
..#..#..........
..#.............
................
...........##...
............#...
............#...
......#######...
......#.........
................